WE  xpm/test2.xpm 
NO  xpm/test4.xpm
SO  xpm/test1.xpm
EA  xpm/test3.xpm

F 255,100,1
C 225,30,0



11111111111111111111111111111111111111
1000100000000W000000000000000000000001
11111111111100000000000000000000000001
           100011111111111111111100001
           10001                100001
           10001                100001
           10001                100001
           10001                100001
           100011111111111111111100001
           100000000000000000000000001
           111111111111111111111111111